NO ./textures/wall_north.png
SO ./textures/wall_south.png
WE ./textures/wall_west.png
EA ./textures/wall_east.png
F 175,225,14
C 255,255,0



111111111111111111
1100000011010101111
 100000111111000001
 1000E00000000011
110000011101010111
11110111 1110101
1111111 1111111
