NO ./textures/wall_north.xpm
SO ./textures/wall_south.xpm
WE ./textures/wall_west.xpm
EA ./textures/wall_east.xpm
F 175,225,14
C 0,255,222



111111111111111111
11000000110101W111
100000111111000001
100000000000000011
110000011101010111
11110111 1110101
1111111 1111111
