NO ./textures/wall_north.png
SO ./textures/wall_south.png
WE ./textures/wall_west.png
EA ./textures/wall_east.png
F 83,92,104
C 34,166,179


1111111111111111111
1000000001110000001
1000000001110000000
1010101011110101011
1010101011110101011
10101010111101W1011
1010101011110101011
1110111011110111011
1110111011110111011
1100001111110111011
1100001111111111011
1110111111111111011
111111111111111111
