NO ./textures/wall_north.png
SO ./textures/wall_south.png
WE ./textures/wall_west.png
EA ./textures/wall_east.png

F 220,100,0
C 225,30,0


11111111
100000W01
100000001
100000001
100000001
100000001
100000001
11111111
